NO ./img/brick.xpm
SO ./img/blue.xpm
WE ./img/wood.xpm
EA ./img/grey.xpm

F 100,0,100
C 0,0,0

      111111111111111111
      111110000011111111
111111111000000011
100000000000000001
1000000S0000000001
100000000000000001
100000000000000001
100000000000000001
100000000000000001
111111111111111111